{
  "version": 2,
  "id": "boss_shattered_oval_01",
  "roomType": "Boss",
  "size": {"w": 36, "h": 28},
  "walkable": [
    "................####................",
    "................####................",
    "...........##############...........",
    ".........##################.........",
    ".......######################.......",
    "......########################......",
    ".....##########################.....",
    "....############################....",
    "...##############################...",
    "..################################..",
    "..################################..",
    ".##################################.",
    ".##################################.",
    ".##################################.",
    ".##################################.",
    ".##################################.",
    ".##################################.",
    ".##################################.",
    "..################################..",
    "..################################..",
    "....############################....",
    "....############################....",
    ".....##########################.....",
    "......########################......",
    "........####################........",
    ".........##################.........",
    "...........##############...........",
    "...................................."
  ],
  "spawn": {"x": 17, "y": 26},
  "exitSlots": {
    "NW": {"x": 12, "y": 2},
    "N": {"x": 17, "y": 0},
    "NE": {"x": 23, "y": 2}
  },
  "props": [
  ],
  "enemySpawns": [
    {"x": 18, "y": 14, "tier": "boss"}
  ],
  "notes": ""
}